"filename", "language", "C++", "Markdown", "comment", "blank", "total"
"/home/xein/Documents/CPPTEST/Elevator/README.md", "Markdown", 0, 25, 0, 2, 27
"/home/xein/Documents/CPPTEST/Elevator/include/elevator.hpp", "C++", 36, 0, 7, 8, 51
"/home/xein/Documents/CPPTEST/Elevator/include/elevsystem.hpp", "C++", 17, 0, 0, 6, 23
"/home/xein/Documents/CPPTEST/Elevator/include/person.hpp", "C++", 25, 0, 6, 9, 40
"/home/xein/Documents/CPPTEST/Elevator/include/stimula.hpp", "C++", 13, 0, 0, 4, 17
"/home/xein/Documents/CPPTEST/Elevator/src/elevator.cpp", "C++", 103, 0, 25, 14, 142
"/home/xein/Documents/CPPTEST/Elevator/src/elevsystem.cpp", "C++", 45, 0, 10, 8, 63
"/home/xein/Documents/CPPTEST/Elevator/src/main.cpp", "C++", 33, 0, 5, 11, 49
"/home/xein/Documents/CPPTEST/Elevator/src/person.cpp", "C++", 52, 0, 11, 12, 75
"/home/xein/Documents/CPPTEST/Elevator/src/stimula.cpp", "C++", 61, 0, 7, 5, 73
"Total", "-", 385, 25, 71, 79, 560